 8             8 
 32  0  0  32  0 -890  32  0  0  32  0  0  32  0  0  32  0  0  32  0  0  32  0  0 
 32  0  0  32  0  0  32  0  0  32  0  0  32  0  0  32  0  888  32  0  0  32  0 -890 
 32  0  0  32  0  0  32  0  0  32  0  0  32  0  0  32  0  0  32  0  0  32  0  0 
 32  0  0  32  0  0  32  0  0  32  0  0  32  0  0  32  0  0  32  0  0  32  0  0 
 32  0  0  32  0  0  32  0  891  32  0  0  32  0 -890  32  0  0  32  0  0  32  0  0 
 32  0  0  32  0  0  32  0  0  32  0  0  32  0  0  32  0  0  32  0 -890  32  0  0 
 32  0 -890  32  0  0  32  0  0  32  0  888  32  0  0  32  0  0  32  0  0  32  0  0 
 32  0  0  32  0  0  32  0  0  32  0  0  32  0  0  32  0  0  32  0  0  32  0  0 
 0             0 
 0 
