 6             15 
 0  0  0  0  0  0  0  0  0  0  0  0  32  0 -890  32 -229  0 
 0  0  0  0  0  0  32  0  0  32  0  0  32  0  0  32 -229 -61 
 0  0  0  32  0  0  32  234  206  32  0  0  32  0  0  32 -229  0 
 0  0  0  32  0  0  32  0  0  32  0  0  0  0  0  0  0  0 
 0  0  0  0  0  0  32  0  906  0  0  0  0  0  0  0  0  0 
 0  0  0  32  232  192  32 -253  0  32  232  192  0  0  0  0  0  0 
 0  0  0  32  0  0  32  0  0  32  0  0  32  0  0  0  0  0 
 0  0  0  32  0  0  32  0  0  32  0  0  32  0 -890  0  0  0 
 0  0  0  0  0  0  32  0  0  32  0  0  0  0  0  0  0  0 
 0  0  0  0  0  0  32  0  0  0  0  0  0  0  0  0  0  0 
 0  0  0  0  0  0  32  0  0  32  0  0  0  0  0  0  0  0 
 0  0  0  0  0  0  0  0  0  32  0 -890  0  0  0  0  0  0 
 0  0  0  0  0  0  0  0  0  32  0  0  32  0  0  0  0  0 
 0  0  0  0  0  0  0  0  0  0  0  0  32  0  0  0  0  0 
 0  0  0  0  0  0  0  0  0  0  0  0  66 -228  0  0  0  0 
 5             15 
 0 
