 3             6 
 32 -600  0  32  0  0  108 -596  0 
 32 -600  0  32 -600  0  32  0  0 
 32 -600  0  32  0  901  32 -600  0 
 32 -600  0  32  604  902  32 -600  0 
 32 -600  0  32 -600  0  32 -600  0 
 32 -600  0  32 -600  0  32 -600  0 
 3             1 
 0 
