 11            11 
 0  0  0  0  0  0 -6  0  0 -6  0  0 -6  0  0 -6  0  0 -6  0  0 -6  0  0 -6  0  0  0  0  0  0  0  0 
 0  0  0 -6  0  0 -6  0  0  8  0  0  8  0  0  8  0  0  8  0  0  8  185  840 -6  0  0 -6  0  0  0  0  0 
-6  0  0 -6  0  0 -6  0  0  8  0  0  8  0  0  8  0  0  8  0  0  8  0  0 -6  0  0 -6  0  0 -6  0  0 
-6  0  0 -6  0  0 -6  0  0  8  4  851 -6  0  0 -6  0  0 -6  0  0 -6  0  0 -6  0  0 -6  0  0 -6  0  0 
-6  0  0  8  185  845  8  0  0  8  0  0 -6  0  0  8 -247 -871 -6  0  0  8 -246 -872 -6  0  0 -6  0  0 -6  0  0 
-6  0  0  8  0  830  8  0  0  8  0  0 -6  0  0  8  0  0 -6  0  0  8  0  0 -6  0  0 -6  0  0 -6  0  0 
-6  0  0  8  0  831  8  0  0  8  0  0 -6  0  0  8  0  0  8  0  0  8  555  160  8  0  0  8  148  883 -6  0  0 
-6  0  0  8  0  0  8  0  0  8  0  0  8  2  849  8  0  0  8  0  0  8  0  0  8  0  0  8  0  870 -6  0  0 
-6  0  0 -6  0  0  8  10  835  8  0  0 -6  0  0  8  0  0  8  0  0  8  0  0  8  0  0 -6  0  0 -6  0  0 
 0  0  0 -6  0  0 -6  0  0 -6  0  0 -6  0  0  8  185  839  8  0  0  8  0  0 -6  0  0 -6  0  0  0  0  0 
 0  0  0  0  0  0 -6  0  0 -6  0  0 -6  0  0 -6  0  0 -6  0  0 -6  0  0 -6  0  0  0  0  0  0  0  0 
 8             5 
 0 
