 30            33 
-6  0  0 -6  0  0 -6  0  0 -6  0  0  1  0  0  1  0  0  1  0  0  1  0  0  1  0  0  1  0  0  1  0  0  1  0  0  1  0  0  1  0  0  1  0  0  1  0  0  1  0  0  1  0  0  1  0  0  1  0  0  1  0  0  1  0  0  1  0  0  1  0  0  1  0  0  1  0  0 -6  0  0 -6  0  0 -6  0  0 -6  0  0 
-6  0  0  7  0  0  7  0  0 -6  0  0 -6  0  0 -6  0  0 -6  0  0 -6  0  0 -6  0  0 -6  0  0 -6  0  0 -6  0  0 -6  0  0 -6  0  0 -6  0  0 -6  0  0 -6  0  0 -6  0  0 -6  0  0 -6  0  0 -6  0  0 -6  0  0 -6  0  0 -6  0  0 -6  0  0 -6  0  0 -6  0  0  7  0  0  7  789  226 -6  0  0 
-6  0  0  7  0  0  7  0  0  7  0  0  7  0  0  7  0  40  7  0  0  7  0  0  7  0  0  7  0  0  7  0  0  7  0  0  7  0  0  7  0  0  7  0  0  7  0  0  7  0  0  7  0  0  7  0  0  7  0  0  7  0  0  7  0  0  7  0  0  7  0  0  7  0  0  7  0  0  7  0  0  7  0  0  7  0  0 -6  0  0 
-6  0  0 -6  0  0  7  0  0  1  0  0  1  0  0  1  0  41  1  0  0  1  0  0  1  0  0  1  0  0  1  0  0  1  0  0  1  0  0  1  0  0  1  0  0  1  0  40  1  0  0  1  0  0  1  0  0  1  0  0  1  0  0 -36  0  0 -36  0  0 -36  0  0 -36  0  0 -36  0  0  1  0  0  7  0  0 -6  0  0 -6  0  0 
 1  0  0 -6  0  0  7  0  0  1  0  0  1  0  0  1  0  544  1  0  552  1  0  547  1  0  0  1  0  0  1  0  0  1  0  40  1  0  0  1  0  0  1  0  0  1  0  41  1  0  0  1  0  0  1  0  0  1  0  0 -36  0  0 -36  0  0  4  9  1285  4  0  0  4  9  1287 -36  0  0 -36  0  0  7  0  0 -6  0  0  1  0  0 
 1  0  0 -6  0  0  7  0  0  1  0  0  1  0  0  1  0  545  1336  0  553  1  0  548  1  0  0  1  0  0  1  0  0  1  0  41 -36  0  0 -36  0  0 -36  0  0 -36  0  0 -36  0  0 -36  0  0 -36  0  0 -36  0  0 -36  0  0  4  9  1286  4  0  0  4  690  177  4  0  0  4  9  1284 -36  0  0  7  0  0 -6  0  0  1  0  0 
 1  0  0 -6  0  0  7  0  0  1  0  0  1  0  0  1  0  546  1  0  534  1  0  549  1  679  208  1  0  0  1  0  0 -36  0  0 -36  0  0  4  9  1284  4  0  0  4  0  0  4  0  0  4  0  0  4  0  0  4  0  0  4  2  849  4  0  0  4  0  0  4  0  0  4  0  0  4  9  1286 -36  0  0  7  0  0 -6  0  0  1  0  0 
 1  0  0 -6  0  0  7  0  0  1  0  40  1  0  0  1  0  0  1  0  0  1  0  0  1  0  0  1  0  0  1  0  0 -36  0  0  4  9  1287  4  0  0  4  0  0  4  0  0  4  0  0  4  0  0  4  0  0  4  0  0 -36  0  0 -36  0  0  4  9  1287  4  0  0  4  9  1284 -36  0  0 -36  0  0  7  0  0 -6  0  0  1  0  0 
 1  0  0 -6  0  0  7  0  0  1  0  41  1  0  0  1  0  38  1  0  0  1  0  0  1  0  0  1  0  38  1  0  40 -36  0  0  4  0  0  4  0  0  4  0  0  4  679  180  4  0  0  4  0  0  4  0  0  4  0  0  4  9  1286 -36  0  0 -36  0  0 -36  0  0 -36  0  0 -36  0  0 -36  0  0  7  0  0 -6  0  0  1  0  0 
 1  0  0 -6  0  0  7  0  0  1  0  0  1  0  38  1  0  39  1  0  0  1  0  0  1  0  40  1  0  39  1  0  41 -36  0  0  4  0  0  4  0  0  4  0  0  4  0  0  4  0  0  4  0  0  4  679  210  4  0  0  4  0  0 -36  0  0  4  0  0  4  0  0  4  0  0  4  9  1285 -36  0  0  7  0  0 -6  0  0  1  0  0 
 1  0  0 -6  0  0  7  0  0  1  0  0  1  0  39  1  0  0  1  0  0  1  0  0  1  0  41  1  0  0  1  0  0 -36  0  0  4  0  0  4  0  0  4  0  0  4  0  0  4  0  0  4  0  0  4  0  0  4  0  0  4  0  0 -36  0  0  4  0  0  4  311  223  4  0  0  4  0  0 -36  0  0  7  0  0 -6  0  0  1  0  0 
 1  0  0 -6  0  0  7  0  0  1  0  0  1  0  0  1  0  0  1  0  0  1  0  0  1  0  0  1  0  40  1  0  0 -36  0  0  4  9  1285  4  0  0  4  0  0  4  0  0  4  0  0  4  0  0  4  0  0  4  0  0  4  0  0  4  296  223  4  0  0  4  0  0  4  0  0  4  9  1284 -36  0  0  7  0  0 -6  0  0  1  0  0 
 1  0  0 -6  0  0  7  0  0  1  0  0  1  856  829  1  0  0  1  0  38  1  0  0  1  0  0  1  0  41  1  0  0 -36  0  38 -36  0  0  4  9  1284  4  0  0  4  0  0  4  0  0  4  0  0  4  0  0  4  0  0  4  9  1284 -36  0  0  4  0  0  4  0  0  4  9  1287 -36  0  0 -36  0  0  7  0  0 -6  0  0  1  0  0 
 1  0  0 -6  0  0  7  0  0  1  0  40  1  0  0  1  0  0  1  0  39  1  0  0  1  0  0  1  0  0  1  0  40  1  0  39 -36  0  0 -36  0  0  7  0  0  7  0  0 -36  0  0 -36  0  0 -36  0  0 -36  0  0 -36  0  0 -36  0  0 -36  0  0 -36  0  0 -36  0  0 -36  0  0  1  0  0  7  0  0 -6  0  0  1  0  0 
 1  0  0 -6  0  0  7  0  0  1  0  41  1  0  40  1  0  0  1  0  0  1  679  195  1  0  0  1  0  38  1  0  41  1  0  0  1  0  30  1  0  30  7  0  0  7  0  0  1  0  30  1  0  30  1  0  30  1  0  30  1  0  30  1  0  30  1  0  30  1  0  30  1  0  30  1  0  30  1  0  30  7  0  0 -6  0  0  1  0  0 
 1  0  0 -6  0  0  7  0  0  1  0  0  1  0  41  1  0  0  1  0  0  1  0  0  1  0  0  1  0  39  1  0  38  1  789  234  7  0  0  7  0  0  7  0  0  7  666  192  7  0  820  7  0  207  7  0  0  7  0  162  7  0  0  7  0  820  7  666  192  7  0  0  7  0  0  7  0  0  7  0  0  7  0  0 -6  0  0  1  0  0 
 1  0  0 -6  0  0  7  0  0  1  0  0  1  0  0  1  0  0  1  0  0  1  0  0  1  0  0  1  0  0  1  0  39  1  0  0  1  0  30  7  0  0  7  0  0  7  0  0  7  0  861  7  667  856  7  0  856  7  668  856  7  0  856  7  0  862  7  0  0  7  0  0  7  0  859  7  665  856  1  0  30  7  0  0 -6  0  0  1  0  0 
 1  0  0 -6  0  0  7  0  0 -36  0  0 -36  0  0 -36  0  0 -36  0  0 -36  0  0 -36  0  0 -36  0  0 -36  0  0 -36  0  0  1  0  30  7  784  856  7  0  860  7  0  0  7  0  0  7  0  0  7  0  0  7  0  0  7  0  0  7  0  0  7  0  0  7  0  0  7  665  820  7  0  235  1  0  30  7  0  0 -6  0  0  1  0  0 
 1  0  0 -6  0  0  7  0  0 -36  0  0  8  9  1286  8  0  801  8  0  0 -36  0  0  8  9  1284  8  0  801  8  0  0 -36  0  0  1  0  30  7  0  190  7  784  820  7  0  0  7  0  0  7  0  0  7  0  0  7  0  0  7  0  0  7  0  859  7  664  856  7  0  856  7  0  862  7  0  0  1  0  30  7  0  0 -6  0  0  1  0  0 
 1  0  0 -6  0  0  7  0  0 -36  0  0  8  0  0  8  0  802  8  0  0 -36  0  0  8  0  0  8  0  802  8  0  0 -36  0  0  1  0  30  7  0  0  7  0  820  7  0  0  7  0  0  7  0  0  7  0  0  7  0  0  7  0  0  7  664  820  7  0  196  7  0  0  7  0  0  7  0  0  1  0  30  7  0  0 -6  0  0  1  0  0 
 1  0  0 -6  0  0  7  0  0 -36  0  0  8  0  0  8  0  0  8  0  0 -36  0  0  8  0  0  8  0  0  8  0  0 -36  0  0  1  0  30  7  0  209  7  663  820  7  0  0  7  0  0  7  0  0  7  0  0  7  0  0  1  0  30  1  0  30  1  0  30  1  0  30  1  0  30  1  0  30  1  0  30  7  0  0 -6  0  0  1  0  0 
 1  0  0 -6  0  0  7  0  0 -36  0  0 -36  0  0  8  4  851 -36  0  0 -36  0  0 -36  0  0  8  4  851 -36  0  0 -36  0  0  1  0  30  7  0  0  7  0  820  7  0  0  7  0  0  7  0  0  7  270  204  7  0  0  1  0  30 -36  0  0 -36  0  0 -36  0  0 -36  0  0 -36  0  0 -36  0  0  7  0  0 -6  0  0  1  0  0 
 1  0  0 -6  0  0  7  0  0 -36  0  0  8  0  0  8  0  0  8  0  0  8  0  0  8  0  0  8  0  0  8  0  0 -36  0  0  1  0  30  7  0  856  7  0  862  7  0  0  7  0  0  7  0  0  7  0  0  7  0  0  1  0  30 -36  0  0  8  185  840  8  0  0  8  0  820  8  0  0 -36  0  0  7  789  234 -6  0  0  1  0  0 
 1  0  0 -6  0  0  7  0  0 -36  0  0  8  0  0  8  0  0  8  0  0  8  0  0  8  0  0  8  0  0  8  0  0 -36  0  0  1  644  867  7  0  0  7  0  0  7  0  0  7  0  0  7  0  0  7  0  0  7  0  0  1  0  30 -36  0  0  8  0  0  8  0  0  8  642  820  8  0  160 -36  0  0  7  0  0 -6  0  0  1  0  0 
 1  0  0 -6  0  0  7  0  0 -36  0  0  8  0  856  8  0  856  8  0  856  8  0  860  8  0  0  8  0  0  8  0  0  7  0  0  7  0  0  7  0  0  7  0  0  7  0  0  7  0  0  7  0  0  7  0  0  7  0  0  1  0  30 -36  0  0  8  0  0  8  0  0  8  0  861  8  642  856 -36  0  0  7  0  0 -6  0  0  1  0  0 
 1  0  0 -6  0  0  7  0  0 -36  0  0  8  0  0  8  0  0  8  0  0  8  0  820  8  0  0  8  0  0  8  713  845 -36  0  0  1  0  30  7  0  0  7  679  199  7  0  0  7  0  0  7  0  0  7  0  0  7  0  0  7  0  0  7  0  0  8  0  0  8  916  1413  8  0  0  8  0  0 -36  0  0  7  0  0 -6  0  0  1  0  0 
-6  0  0 -6  0  0  7  0  0 -36  0  0 -36  0  0 -36  0  0 -36  0  0 -36  0  0 -36  0  0 -36  0  0 -36  0  0 -36  0  0  1  0  30  7  0  0  7  0  0  7  0  0  7  0  0  7  0  0  7  0  0  7  0  0  1  0  30 -36  0  0 -36  0  0 -36  0  0 -36  0  0 -36  0  0 -36  0  0  7  0  0 -6  0  0 -6  0  0 
-6  0  0  7  0  0  7  0  0  7  0  0  7  0  0  7  0  0  7  0  0  7  0  0  7  0  0  7  0  0  7  0  0  7  0  0  7  0  0  7  0  0  7  0  0  7  0  0  7  643  867  7  0  0  7  0  0  7  0  0  7  0  0  7  0  0  7  0  0  7  0  0  7  0  0  7  0  0  7  0  0  7  0  0  7  0  0 -6  0  0 
-6  0  0  7  0  0  7  0  0 -6  0  0 -6  0  0 -6  0  0 -6  0  0 -6  0  0 -6  0  0 -6  0  0 -6  0  0 -6  0  0 -6  0  0 -6  0  0 -6  0  0  7 -22  0 -6  0  0 -6  0  0 -6  0  0 -6  0  0 -6  0  0 -6  0  0 -6  0  0 -6  0  0 -6  0  0 -6  0  0 -6  0  0  7  0  0  7  0  0 -6  0  0 
-6  0  0 -6  0  0 -6  0  0 -6  0  0  1  0  0  1  0  0  1  0  0  1  0  0  1  0  0  1  0  0  1  0  0  1  0  0  1  0  0  1  0  0  1  0  0 -7  0  0  1  0  0  1  0  0  1  0  0  1  0  0  1  0  0  1  0  0  1  0  0  1  0  0  1  0  0  1  0  0 -6  0  0 -6  0  0 -6  0  0 -6  0  0 
 1  0  0  1  0  0  1  0  0  1  0  0  1  0  0  1  0  0  1  0  0  1  0  0  1  0  0  1  0  0  1  0  0  1  0  0  1  0  0  1  0  0  1  0  0 -7  0  0  1  0  0  1  0  0  1  0  0  1  0  0  1  0  0  1  0  0  1  0  0  1  0  0  1  0  0  1  0  0  1  0  0  1  0  0  1  0  0  1  0  0 
 1  0  0  1  0  0  1  0  0  1  0  0  1  0  0  1  0  0  1  0  0  1  0  0  1  0  0  1  0  0  1  0  0  1  0  0  1  0  0  1  0  0  1  0  0 -7  0  0  1  0  0  1  0  0  1  0  0  1  0  0  1  0  0  1  0  0  1  0  0  1  0  0  1  0  0  1  0  0  1  0  0  1  0  0  1  0  0  1  0  0 
 1  0  0  1  0  0  1  0  0  1  0  0  1  0  0  1  0  0  1  0  0  1  0  0  1  0  0  1  0  0  1  0  0  1  0  0  1  0  0  1  0  0  1  0  0 -7  0  0  1  0  0  1  0  0  1  0  0  1  0  0  1  0  0  1  0  0  1  0  0  1  0  0  1  0  0  1  0  0  1  0  0  1  0  0  1  0  0  1  0  0 
 16            29 
 1 
