 12            12 
 1  0  62  1  0  62  1  0  62  1  0  62  1  0  62  1  0  62  1 -700  0  1  0  62  1  0  62  1  0  62  1  0  62  1  0  62 
 1  0  62  1  0  0  1  0  0  1  0  0  1  64  446  1  0  0  1  0  0  1  0  0  1  0  0  1  55  447  1  0  0  1  0  62 
 1  0  62  1  0  0  1  0  0  1  0  0  1  0  0  1  0  0  1  0  0  1  0  0  1  0  0  1  0  0  1  0  0  1  0  62 
 1  0  62  1  27  324  1  0  0  1  0  0  1  0  0  1  0  0  1  64  446  1  0  0  1  27  324  1  0  0  1  0  0  1  0  62 
 1  0  62  1  0  0  1  0  0  1  0  0  1  0  0  1  0  0  1  0  0  1  0  0  1  0  0  1  0  0  1  0  0  1  0  62 
 1 -700  0  1  0  0  1  0  0  1  27  324  1  0  0  1  0  0  1  0  0  1  0  0  1  0  0  1  64  446  1  0  0  1 -700  0 
 1  0  62  1  0  0  1  0  0  1  0  0  1  0  0  1  0  0  1  55  447  1  0  0  1  0  0  1  27  324  1  0  0  1  0  62 
 1  0  62  1  0  0  1  0  0  1  0  0  1  0  0  1  0  0  1  0  0  1  0  0  1  0  0  1  0  0  1  0  0  1  0  62 
 1  0  62  1  0  0  1  0  0  1  64  446  1  0  0  1  0  0  1  0  0  1  0  0  1  0  0  1  0  0  1  0  0  1  0  62 
 1  0  62  1  0  0  1  27  324  1  0  0  1  0  0  1  0  0  1  0  0  1  0  0  1  0  0  1  0  0  1  55  447  1  0  62 
 1  0  62  1  0  0  1  0  0  1  0  0  1  0  0  1  0  0  1  0  0  1  27  324  1  0  0  1  0  0  1  0  0  1  0  62 
 1  0  62  1  0  62  1  0  62  1  0  62  1  0  62  1 -700  0  1  0  62  1  0  62  1  0  62  1  0  62  1  0  62  1  0  62 
 6             6 
 1 
