 10            10 
-32  0  0 -32  0  0  32  0  0 -32  0  0  32  0  0  32  0  0  32  0  0  32  0  0 -32  0  0  32  214  323 
 32  0  0  32  0  0  32  0  0 -32  0  0  32  0  0 -32  0  0 -32  0  0  32  0  0  32  0 -890  32  0  0 
 32  0  0 -32  0  0  32  0  0  32  0 -890  32  0  0 -32  0  0 -32  0  0 -32  0  0 -32  0  0 -32  0  0 
 32  0 -890  32  0  0 -32  0  0 -32  0  0 -32  0  0  32  0  0 -32  0  0 -32  0  0  32  0  0  32  0  0 
 32  0  0 -32  0  0  32  0  0  32  0  0  32  0  0  32  0  0  32  0  0  32  0  0 -32  0  0  32  0 -890 
 32  0  0 -32  0  0  32  0  0 -32  0  0 -32  0  0 -32  0  0 -32  0  0  32  0  0 -32  0  0  32  0  0 
 32  0  0  32  0  0  32  0 -890  32  0  0 -32  0  0  32  0  0  32  0  0  32  0  0 -32  0  0  32  0  0 
-32  0  0 -32  0  0  32  0  0 -32  0  0 -32  0  0  32  0  0 -32  0  0 -32  0  0 -32  0  0  32  0  0 
 32  0  0  32  0  0  32  0  0 -32  0  0  32  0  0  32  0  0  32  0 -890  32  0  0  32  0  0  32  0  0 
 0  0  0  0  0  0  0  0  0  0  0  0  0  0  0  0  0  0  0  0  0  0  0  0  66 -187  0  66  215  867 
 9             10 
 0 
