 7             7 
 0  0  0 -6  0  0 -6  0  0 -6  0  0 -6  0  0 -6  0  0  0  0  0 
-6  0  0 -6  0  0 -6  0  0 -6  0  0 -6  0  0 -6  0  0 -6  0  0 
-6  0  0  8  0  0  8  0  0  8 -249 -871 -6  0  0  8 -247 -872 -6  0  0 
-6  0  0  8  550  906 -899  546  0 -899  543  0 -899  540  0  8  0  0 -6  0  0 
-6  0  0  8 -549  0  8  0  0  8  0  0  8  0  0  8  0  0 -6  0  0 
-6  0  0 -6  0  0 -6  0  0 -6  0  0 -6  0  0 -6  0  0 -6  0  0 
 0  0  0 -6  0  0 -6  0  0 -6  0  0 -6  0  0 -6  0  0  0  0  0 
 6             3 
 0 
