 20            20 
-54  0  0 -54  0  0 -54  0  0 -54  0  0 -54  0  0 -54  0  0 -54  0  0 -54  0  0 -57  0 -53  58  0  0  58  0  0  58  0  0  56  0 -53 -54  0  0 -54  0  0 -54  0  0 -54  0  0 -54  0  0 -54  0  0 -54  0  0 
-54  0  0 -54  0  0 -54  0  0 -54  0  0 -54  0  0 -54  0  0 -57  0 -53  58  0  0  1  0  0  1  0  0  1  0  0  1  0  0  56  0  0 -54  0  0 -54  0  0 -54  0  0 -54  0  0 -54  0  0 -54  0  0 -54  0  0 
-54  0  0 -54  0  0 -54  0  0 -54  0  0 -54  0  0 -57  0 -53  1  0  0  1  0  0  1  0  0  120  0  0  119  0  0  119  0  0  1  0  0  56  0 -53 -54  0  0 -54  0  0 -54  0  0 -54  0  0 -54  0  0 -54  0  0 
-54  0  0 -54  0  0 -54  0  0 -54  0  0 -54  0  0 -57  0  0  1  0  0  129  0  0  1  0  0  1  0  0  121  0  0  119  0  0  1  0  0  128  0  0  56  0 -53 -54  0  0 -54  0  0 -54  0  0 -54  0  0 -54  0  0 
-54  0  0 -54  0  0 -54  0  0 -54  0  0 -57  0 -53  1  0  0  1  0  0  1  0  528  1  0  530  1  0  0  1  0  0  121  520  0  1  508  0  1  0  0  1  0  0  56  0 -53 -54  0  0 -54  0  0 -54  0  0 -54  0  0 
-54  0  0 -54  0  0 -54  0  0 -54  0  0 -57  0  0  1  0  0  1336  0 -10  1336  0  529  1336  0  531  1  0  0  1336  0 -10  1336  0 -20  1336  520  216  1  508  900  1  0  0  56  0  0 -54  0  0 -54  0  0 -54  0  0 -54  0  0 
-54  0  0 -54  0  0 -54  0  0 -57  0 -53  1  0  0  1336  0 -10  1336  0 -21 -1336  0  908  1336  0 -16  1336  0 -122  1336  0 -21  1336  0  1280  1336  0 -14  1  0  0  129  0  0  1  0  0  56  0 -53 -54  0  0 -54  0  0 -54  0  0 
-54  0  0 -54  0  0 -54  0  0 -57  0  0  1  0  0  1336  0 -18 -1336  0  909 -1336  0  0 -1336  0  908  1336  0 -123 -1336  0  910 -1336  0  909  1336  0 -14  1  0  0  1  0  0  1  0  0  1  0  0  58  0  0  56  0 -53 -54  0  0 
-57  0 -53  58  0  0  58  0  0  1  0  0  1336  0 -10  1336  0 -21 -1336  0  911 -1336  0  0 -1336  0  0 -1336  0  908 -1336  0  0 -1336  0  911  1336  0 -16  1336  0 -12  1  0  0  1  0  0  119  0  0  1  0  0  56  0  0 -54  0  0 
-57  0  0  128  0  0  1  0  0  1336  0 -10  1336  0 -21 -1336  0  909 -1336  0  0 -1336  0  0 -1336  0  0 -1336  0  0 -1336  0  0 -1336  0  0 -1336  0  0  1336  0 -16  1336  0 -20  1336  0 -12  1  0  0  1  0  0  56  0 -50 -54  0  0 
-57  0  0  1  0  0  1  16  214  1336  0 -18 -1336  0  908 -1336  0  911 -1336  0  0 -1336  0  0 -1336  0  0 -1336  0  0 -1336  0  0 -1336  0  0 -1336  0  0 -1336  0  908 -1336  0  909  1336  0 -14  1  0  0  56  0 -50 -54  0  0 -54  0  0 
-57  0  0  1  0  0  1  0  0  1336  0 -18 -1336  0  908 -1336  0  910 -1336  0  909 -1336  0  0 -1336  0  0 -1336  0  0 -1336  0  0 -1336  0  0 -1336  0  0 -1336  0  0 -1336  0  911  1336  0 -16  1336  0 -110 -54  0  0 -54  0  0 -54  0  0 
-57  0  0  1  0  0  1  0  0  1336  0 -11  1336  0 -17  1336  0 -19 -1336  0  911 -1336  0  0 -1336  0  0 -1336  0  908 -1336  0  910 -1336  0  909 -1336  0  0 -1336  0  0 -1336  0  0 -1336  0  0 -1336  0  51 -54  0  0 -54  0  0 -54  0  0 
-57  0  50  1  0  0  1  0  0  1  378  867  1  0  0  1336  0 -18 -1336  0  908 -1336  0  0  1336  0 -15  1336  0 -17  1336  0 -19 -1336  0  911 -1336  0  0 -1336  0  0 -1336  0  0 -1336  0  0 -1336  0  51 -54  0  0 -54  0  0 -54  0  0 
-54  0  0 -57  0  0  129  0  0  1  0  0  1  0  0  1336  0 -11  1336  0 -17  1336  0 -17  1336  0 -13  1  0  0  1336  0 -18 -1336  0  908 -1336  0  909 -1336  0  0 -1336  0  0 -1336  0  0 -1336  0  51 -54  0  0 -54  0  0 -54  0  0 
-54  0  0 -57  0  50  1  0  0  120  0  0  1  0  0  1  0  0  1  0  0  1  0  0  1  0  0  128  0  0  1336  0 -11  1336  0 -19 -1336  0  911 -1336  0  0 -1336  0  0 -1336  0  0  1336  0  91 -54  0  0 -54  0  0 -54  0  0 
-54  0  0 -54  0  0 -57  0  50  1  0  0  1  0  0  1  782  209  1  0 -50  1  0  0  1  0  0  1  0  0  1  0  0  1336  0 -11  1336  0 -17  1336  0 -19 -1336  0  50 -1336  0  91 -54  0  0 -54  0  0 -54  0  0 -54  0  0 
-54  0  0 -54  0  0 -54  0  0 -57  0  50  1  0 -50  56  0 -50 -54  0  0 -57  0 -50  1  0  0  1  0  0  1  0  0  55  0  0  1  0 -50  1336  0 -109 -54  0  0 -54  0  0 -54  0  0 -54  0  0 -54  0  0 -54  0  0 
-54  0  0 -54  0  0 -54  0  0 -54  0  0 -54  0  0 -54  0  0 -54  0  0 -54  0  0 -57  0 -50  55  0  0  56  0 -50 -54  0  0 -54  0  0 -54  0  0 -54  0  0 -54  0  0 -54  0  0 -54  0  0 -54  0  0 -54  0  0 
-54  0  0 -54  0  0 -54  0  0 -54  0  0 -54  0  0 -54  0  0 -54  0  0 -54  0  0 -54  0  0 -54  0  0 -54  0  0 -54  0  0  54  0  0 -54  0  0 -54  0  0 -54  0  0 -54  0  0 -54  0  0 -54  0  0 -54  0  0 
 0             0 
 0 
