 8             8 
 0  0  0  0  0  0  0  0  0  0  0  0  0  0  0  0  0  0  32  0  0  0  0  0 
 0  0  0  32  0  0  32  0  0  32  0  0  32  0  0  32  0  0  32  0  0  32  0  0 
 0  0  0  32  0  0  32  0 -890  32  0  0  32  0  0  32  0  0  32  0  0  0  0  0 
 32  0 -890  32  0  0  32  0  0  32  0  0  32  0  0  32  0  0  32  0  0  0  0  0 
 0  0  0  32  0  0  32  0  0  32  0  0  32  0  0  32  0  0  32  0  0  0  0  0 
 0  0  0  32  0  0  32  0  0  32  0  0  32  0 -890  32  0  0  32  0  0  0  0  0 
 0  0  0  32  0  0  32  0  0  32  0  0  32  0  0  32  0  0  32  0  0  0  0  0 
 0  0  0  0  0  0  0  0  0  0  0  0  0  0  0  32  0 -890  0  0  0  0  0  0 
 0             0 
 0 
