 10            75 
 32  0  0  32  0  0  32  0  0  0  0  0  32  0  0  32  0  0  32  0  0  32  0 -890  32  0  0  1 -190 -96 
 32  0  0  0  0  0  0  0  0  0  0  0  32  0  0  0  0  0  0  0  0  0  0  0  0  0  0  0  0  0 
 32  0  0  32  0 -890  0  0  0  32  0  0  32  0  0  0  0  0  32  0  0  32  0  0  32  0  0  32  0  0 
 0  0  0  32  0  0  0  0  0  32  0  0  0  0  0  0  0  0  0  0  0  0  0  0  0  0  0  32  0  0 
 0  0  0  32  0  0  0  0  0  32  0  0  0  0  0  32  0  0  0  0  0  32  0  0  32  0  0  32  0  0 
 0  0  0  32  0  0  32  0  0  32  0  0  32  0  0  32  0  0  0  0  0  32  0 -890  0  0  0  0  0  0 
 0  0  0  0  0  0  0  0  0  0  0  0  0  0  0  32  0  0  0  0  0  32  0  0  0  0  0  0  0  0 
 0  0  0  0  0  0  32  0  0  32  0  0  32  0  0  32  0  0  0  0  0  32  0  0  32  0  0  0  0  0 
 0  0  0  0  0  0  32  0  0  0  0  0  0  0  0  0  0  0  0  0  0  0  0  0  32  0  0  0  0  0 
 32  0  0  0  0  0  32  0  0  0  0  0  32  0  0  32  0  0  32  0  0  0  0  0  32  0  0  32  0  0 
 32  0 -890  0  0  0  32  0  0  0  0  0  0  0  0  0  0  0  32  0  0  0  0  0  0  0  0  32  0  0 
 32  0  0  0  0  0  32  0  0  32  0  0  32  0  0  0  0  0  32  0  0  32  0  0  0  0  0  32  0  0 
 32  0  0  0  0  0  0  0  0  0  0  0  32  0  0  0  0  0  32  0  0  0  0  0  0  0  0  32  0  0 
 32  0  0  0  0  0  32  0 -890  0  0  0  32  0  0  0  0  0  32  0 -890  0  0  0  32  0  0  32  0  0 
 32  0  0  0  0  0  32  0  0  0  0  0  32  0  0  0  0  0  32  0  0  0  0  0  32  0  0  32  0  0 
 32  0  0  0  0  0  32  0  0  32  0  0  32  0  0  0  0  0  32  0  0  0  0  0  0  0  0  32  0  0 
 32  0  0  0  0  0  32  0  0  0  0  0  32  0  0  0  0  0  32  0  0  32  0  0  0  0  0  32  0  0 
 32  0  0  0  0  0  0  0  0  0  0  0  32  0  0  0  0  0  0  0  0  32  0  0  0  0  0  32  0  0 
 32  0  0  32  0  0  32  0  0  32  0  0  32  0  0  32  0  0  0  0  0  32  0  0  0  0  0  32  0  0 
 0  0  0  0  0  0  0  0  0  0  0  0  0  0  0  32  0  0  0  0  0  32  0  0  0  0  0  32  0 -890 
 0  0  0  32  0  0  32  0  0  32  0  0  32  0  0  32  0  0  0  0  0  32  0  0  0  0  0  32  0  0 
 0  0  0  32  0  0  0  0  0  0  0  0  0  0  0  0  0  0  0  0  0  32  0  0  0  0  0  32  0  0 
 32  0  0  32  0  0  0  0  0  32  0  0  32  0  0  32  0  0  32  0  0  32  0  0  0  0  0  32  0  0 
 32  0  0  0  0  0  0  0  0  32  0  0  0  0  0  32  0  0  0  0  0  0  0  0  0  0  0  32  0  0 
 32  0  0  0  0  0  32  0  0  32  0  0  0  0  0  32  0  0  0  0  0  32  0  0  0  0  0  32  0  0 
 32  0  0  0  0  0  32  0 -890  0  0  0  0  0  0  32  0  0  32  0  0  32  0  0  0  0  0  32  0  0 
 32  0  0  32  0  0  32  0  0  0  0  0  0  0  0  32  0  0  0  0  0  32  0  0  32  0 -890  32  0  0 
 0  0  0  0  0  0  0  0  0  0  0  0  0  0  0  32  0  0  0  0  0  0  0  0  0  0  0  0  0  0 
 32  0  0  32  0  0  32  0  0  32  0 -890  32  0  0  32  0  0  32  0  0  32  0  0  32  0  0  32  0  0 
 32  0  0  0  0  0  0  0  0  0  0  0  0  0  0  0  0  0  0  0  0  0  0  0  0  0  0  0  0  0 
 32  0  0  32  0  0  32  0  0  32  0  0  32  0  0  32  0  0  32  0  0  32  0  0  32  0  0  32  0  0 
 32  0  0  0  0  0  0  0  0  0  0  0  0  0  0  0  0  0  0  0  0  0  0  0  0  0  0  32  0  0 
 0  0  0  0  0  0  32  0  0  32  0  0  32  0  0  0  0  0  32  0  0  32  0 -890  0  0  0  32  0  0 
 32  0  0  32  0  0  32  0 -890  0  0  0  32  0  0  0  0  0  32  0  0  32  0  0  0  0  0  32  0  0 
 32  0  0  0  0  0  32  0  0  0  0  0  32  0  0  32  0  0  32  0 -890  32  0  0  0  0  0  32  0  0 
 32  0  0  0  0  0  32  0  0  0  0  0  0  0  0  0  0  0  32  0  0  32  0  0  0  0  0  32  0 -890 
 32  0  0  0  0  0  32  0  0  0  0  0  32  0  0  0  0  0  0  0  0  0  0  0  0  0  0  32  0  0 
 32  0  0  32  0  0  32  0  0  32  0  0  32  0  0  0  0  0  32  0  0  32  0  0  0  0  0  32  0  0 
 0  0  0  0  0  0  32  0  0  0  0  0  0  0  0  0  0  0  0  0  0  32  0  0  32  0  0  32  0  0 
 32  0  0  32  0  0  32  0  0  32  0  0  32  0  0  32  0  0  0  0  0  0  0  0  0  0  0  32  0  0 
 32  0 -890  0  0  0  0  0  0  0  0  0  0  0  0  32  0  0  32  0  0  32  0  0  0  0  0  32  0  0 
 32  0  0  32  0  0  0  0  0  32  0  0  0  0  0  0  0  0  0  0  0  0  0  0  0  0  0  32  0  0 
 32  0  0  0  0  0  0  0  0  32  0  0  32  0 -890  32  0  0  32  0  0  0  0  0  32  0  0  32  0  0 
 32  0  0  0  0  0  32  0  0  32  0  0  0  0  0  0  0  0  32  0  0  0  0  0  32  0  0  0  0  0 
 32  0  0  0  0  0  0  0  0  32  0  0  32  0  0  0  0  0  32  0  0  0  0  0  32  0  0  0  0  0 
 32  0  0  32  0  0  0  0  0  0  0  0  32  0  0  0  0  0  0  0  0  0  0  0  32  0  0  0  0  0 
 32  0  0  32  0  0  32  0  0  32  0  0  32  0  0  32  0  0  32  0  0  0  0  0  32  0  0  0  0  0 
 32  0  0  32  0  0  0  0  0  0  0  0  0  0  0  0  0  0  0  0  0  0  0  0  32  0  0  0  0  0 
 32  0  0  32  0  0  32  0  0  32  0  0  0  0  0  32  0  0  0  0  0  32  0 -890  32  0  0  0  0  0 
 0  0  0  0  0  0  0  0  0  32  0 -890  0  0  0  32  0  0  0  0  0  0  0  0  32  0  0  0  0  0 
 0  0  0  32  0  0  32  0  0  32  0  0  0  0  0  32  0  0  0  0  0  32  0  0  32  0  0  32  0  0 
 0  0  0  32  0  0  0  0  0  32  0  0  0  0  0  32  0  0  0  0  0  32  0  0  0  0  0  32  0  0 
 0  0  0  32  0  0  0  0  0  32  0  0  0  0  0  32  0  0  0  0  0  32  0  0  0  0  0  0  0  0 
 0  0  0  32  0  0  0  0  0  32  0  0  0  0  0  32  0  0  0  0  0  32  0  0  0  0  0  32  0  0 
 0  0  0  32  0 -890  0  0  0  32  0  0  0  0  0  32  0  0  0  0  0  32  0  0  0  0  0  32  0  0 
 0  0  0  32  0  0  0  0  0  32  0  0  0  0  0  32  0  0  0  0  0  32  0  0  0  0  0  32  0  0 
 0  0  0  32  0  0  32  0  0  32  0  0  0  0  0  32  0  0  0  0  0  32  0  0  0  0  0  32  0  0 
 32  0  0  32  0  0  0  0  0  32  0  0  0  0  0  32  0  0  0  0  0  32  0 -890  0  0  0  32  0  0 
 0  0  0  0  0  0  0  0  0  32  0  0  32  0  0  32  0  0  32  0  0  32  0  0  32  0  0  32  0  0 
 0  0  0  32  0  0  0  0  0  32  0  0  0  0  0  0  0  0  0  0  0  32  0  0  0  0  0  0  0  0 
 0  0  0  32  0  0  32  0  0  32  0  0  0  0  0  32  0  0  32  0  0  32  0  0  32  0  0  32  0  0 
 0  0  0  32  0  0  0  0  0  0  0  0  0  0  0  0  0  0  0  0  0  0  0  0  0  0  0  32  0  0 
 32  0  0  32  0  0  32  0  0  32  0  0  32  0  0  0  0  0  32  0  0  32  0  0  0  0  0  32  0 -890 
 32  0  0  0  0  0  32  0 -890  0  0  0  32  0  0  0  0  0  0  0  0  32  0  0  0  0  0  32  0  0 
 0  0  0  0  0  0  32  0  0  0  0  0  32  0  0  32  0  0  32  0  0  32  0  0  0  0  0  0  0  0 
 32  0  0  32  0  0  32  0  0  0  0  0  0  0  0  0  0  0  32  0  0  32  0  0  32  0  0  32  0  0 
 32  0  0  0  0  0  32  0  0  32  0  0  32  0  0  32  0  0  32  0  0  0  0  0  0  0  0  32  0  0 
 32  0  0  0  0  0  0  0  0  0  0  0  0  0  0  0  0  0  32  0  0  0  0  0  0  0  0  32  0  0 
 32  0  0  0  0  0  32  0  0  0  0  0  32  0  0  0  0  0  32  0  0  32  0  0  0  0  0  32  0  0 
 32  0  0  0  0  0  32  0  0  0  0  0  32  0 -890  0  0  0  0  0  0  0  0  0  0  0  0  32  0  0 
 32  0  0  32  0  0  32  0  0  0  0  0  32  0  0  0  0  0  32  0  0  32  0  0  32  0  0  32  0  0 
 0  0  0  0  0  0  0  0  0  0  0  0  32  0  0  32  0  0  32  0  0  0  0  0  0  0  0  0  0  0 
 0  0  0  0  0  0  32  0 -890  32  0  0  32  0  0  0  0  0  32  0 -890  0  0  0  0  0  0  0  0  0 
 0  0  0  0  0  0  32  0  0  0  0  0  32  0  0  0  0  0  32  0  0  32  0  0  32  0  0  1 -189 -96 
 0  0  0  0  0  0  0  0  0  0  0  0  32  0  0  0  0  0  0  0  0  0  0  0  0  0  0  0  0  0 
 10            74 
 0 
