 20            15 
 0  0  0  0  0  0  0  0  0 -34  0  0 -34  0  0 -34  0  0 -34  0  0 -34  0  0 -34  0  0 -34  0  0 -34  0  0 -34  0  0 -34  0  0 -34  0  0 -34  0  0 -34  0  0 -34  0  0  0  0  0  0  0  0  0  0  0 
 0  0  0  0  0  0  0  0  0 -34  0  0  8  0  839  8  0  830  8  9  1286  8  0  0 -34  0  0  8 -54 -872 -34  0  0  8  0  813  8  0  814  8  0  814 -815  6  852  8  0  0 -34  0  0 -34  0  0 -34  0  0 -34  0  0 
 0  0  0  0  0  0  0  0  0 -34  0  0  8  0  870  8  0  831  8  0  0  8  0  0  8  2  849  8 -272  0 -34  0  0  8  0  812  8  0  0  8  0  0  8  0  812  8  0  0  8  11  847  8  0  0  8  19  323 -34  0  0 
 0  0  0  0  0  0  0  0  0 -34  0  0  8  0  870  8  0  0  8  0  0  8  271  838 -34  0  0  8  0  0 -34  0  0  8  0  0  8  0  0  8  0  0  8  0  0  8  0  0 -34  0  0 -34  0  0 -34  0  0 -34  0  0 
 0  0  0  0  0  0  0  0  0 -34  0  0  8  0  0  8  0  0  8  0  0  8  0  0 -34  0  0  8  0  0  8  0  0  8  0  0  8  0  0  8  0  0  8  0  0  8  0  806  8  0  807  8  0  807  8  0  808 -34  0  0 
 0  0  0  0  0  0  0  0  0 -34  0  0  8  10  835  8  0  0  8  0  0  8  0  0 -34  0  0  8  0  0  8  0  0  8  0  0  8  0  0  8  0  0  8  10  835  8  0  836  8  0  836  8  0  836  8  0  809 -34  0  0 
 0  0  0  0  0  0 -34  0  0 -34  0  0 -34  0  0 -34  0  0 -34  0  0 -34  0  874 -34  0  876 -34  0  878 -34  0  0  8  0  0  8  0  0  8  0  0  8  0  0  8  0  836  8  0  836  8  0  836  8  0  809 -34  0  0 
 0  0  0  0  0  0 -34  0  0  8  8  838  8  0  0  8  90  832  8  0  0  8  0  875  8  273  877  8  0  879 -34  0  0  8  0  0  8  0  0  8  0  0  8  10  835  8  0  836  8  0  836  8  0  836  8  0  810 -34  0  0 
 0  0  0  0  0  0 -34  0  0  8  0  0  8  0  0  8  0  833  8  0  0  8  0  0  8  0  0  8  0  0 -34  0  0  8  0  0  8  0  0  8  0  0  8  0  0  8  0 -837  8  10  834  8  0 -837  8  0  0 -34  0  0 
 0  0  0  0  0  0 -34  0  0  8  0  0  8  0  0  8  0  0  8  0  0  8  0  0  8  0  0  8  0  0  8  2  849  8  0  0  8  0  0  8  0  0  8  0  0  8  0  0  8  0  0  8  0  0  8  0  0 -34  0  0 
 0  0  0  0  0  0 -34  0  0  8  0  0  8  0  0  8  0  0  8  0  0  8  0  0  8  0  0  8  0  0 -34  0  0  8  0  0  8  0  0  8  0  0  8 -20  0  8  0  0  8  0  0  8  0  0  8  0  0 -34  0  0 
 0  0  0  0  0  0 -34  0  0  8  9  1285  8  0  0  8  0  0  8  0  0  8  0  0  8  0  0  8  18  841 -34  0  0 -34  0  0 -34  0  0 -34  0  0  8  21  851 -34  0  0 -34  0  0 -34  0  0 -34  0  0 -34  0  0 
 0  0  0  0  0  0 -34  0  0 -34  0  0 -34  0  0 -34  0  0 -34  0  0 -34  0  0 -34  0  0 -34  0  0 -34  0  0  8  231  826  8  24  827  8  0  0  8  0  0  8  0  0 -34  0  0  0  0  0  0  0  0  0  0  0 
 0  0  0  0  0  0  0  0  0  0  0  0  0  0  0  0  0  0  0  0  0  0  0  0  0  0  0  0  0  0 -34  0  0  8  0  0  8  0  0  8  0  0  8  0  0  8  0  0 -34  0  0  0  0  0  0  0  0  0  0  0 
 0  0  0  0  0  0  0  0  0  0  0  0  0  0  0  0  0  0  0  0  0  0  0  0  0  0  0  0  0  0 -34  0  0 -34  0  0 -34  0  0  8 -22  0 -34  0  0 -34  0  0 -34  0  0  0  0  0  0  0  0  0  0  0 
 6             4 
 0 
