 8             8 
-34  0  0 -34  0  0 -34  0  0 -34  0  0 -34  0  0 -34  0  0 -34  0  0  0  0  0 
-34  0  0  32  145  845  32  10008  187  32  0  0 -34  0  0  32 -23 -871 -34  0  0  0  0  0 
-34  0  0  32  0  870  32  0  0  32  0  0 -34  0  0  32 -101  0 -34  0  0 -34  0  0 
-34  0  0  32  0  870  32  0  0  32  0  0 -34  0  0  32 -102  0  32  173  845 -34  0  0 
-34  0  0  32  0  0  32  0  0  32  0  0 -34  0  0  32  10003  187  32  148  883 -34  0  0 
-34  0  0  32  10005  187  32  0  0  32  0  0  32  0  0  32  0  0  32  0  870 -34  0  0 
-34  0  0  32  103  338  32  0  873  32  174  884  32  0  873  32  0  0  32  0  870 -34  0  0 
-34  0  0 -34  0  0 -34  0  0 -34  0  0 -34  0  0 -34  0  0 -34  0  0 -34  0  0 
 6             2 
 0 
