 50            55 
-71  0  0 -6  0  0 -71  0  0 -6  0  0  0  0  1336  0  0  1336  0  0  1336  0  0  1336  0  0  1336  0  0  1336  0  0  1336  0  0  1336  0  0  1336  0  0  1336  0  0  1336  0  0  1336  0  0  1336  0  0  1336  0  0  1336  0  0  1336  0  0  1336  0  0  1336  0  0  1336  0  0  1336  0  0  1336  0  0  1336  0  0  1336  0  0  1336  0  0  1336  0  0  1336  0  0  1336  0  0  1336  0  0  1336  0  0  1336  0  0  1336  0  0  1336  0  0  1336  0  0  1336  0  0  1336  0  0  1336  0  0  1336  0  0  1336  0  0  1336  0  0  1336  0  0  1336  0  0  1336 -6  0  0 -71  0  0 -6  0  0 -71  0  0 
-6  0  0  70  0  226  70  0  0 -71  0  0 -6  0  0 -6  0  0 -6  0  0 -6  0  0 -6  0  0 -6  0  0 -6  0  0 -6  0  0 -6  0  0 -6  0  0 -6  0  0 -6  0  0 -6  0  0 -6  0  0 -6  0  0 -6  0  0 -6  0  0 -6  0  0 -6  0  0 -6  0  0 -6  0  0 -6  0  0 -6  0  0 -6  0  0 -6  0  0 -6  0  0 -6  0  0 -6  0  0 -6  0  0 -6  0  0 -6  0  0 -6  0  0 -6  0  0 -6  0  0 -6  0  0 -6  0  0 -6  0  0 -6  0  0 -6  0  0 -6  0  0 -6  0  0 -6  0  0 -71  0  0  70  0  0  70  0  226 -6  0  0 
-71  0  0  70  0  0  70  0  0  70  0  0  70  0  0  70  0  0  70  0  226  70  0  0  70  0  0  70  0  0  70  0  0  70  0  0  70  0  0  70  0  0  70  0  0  70  0  0  70  0  0  70  0  0  70  0  0  70  0  0  70  0  0  70  0  0  70  0  0  70  0  0  70  0  0  70  0  0  70  0  0  70  0  0  70  0  0  70  0  0  70  0  0  70  0  0  70  0  0  70  0  0  70  0  0  70  0  0  70  0  0  70  0  0  70  0  0  70  0  0  70  0  0  70  0  0  70  0  0  70  0  234  70  0  0  70  0  0  70  0  0  70  0  0  70  0  0 -71  0  0 
-6  0  0 -71  0  0  70  0  0 -6  0  0 -6  0  0 -6  0  0 -6  0  0 -6  0  0 -6  0  0 -6  0  0 -6  0  0 -6  0  0 -6  0  0 -6  0  0 -6  0  0 -6  0  0 -6  0  0 -6  0  0 -6  0  0 -6  0  0 -6  0  0 -6  0  0 -6  0  0 -6  0  0 -6  0  0 -6  0  0 -6  0  0 -6  0  0 -6  0  0 -6  0  0 -6  0  0 -6  0  0 -6  0  0 -6  0  0 -6  0  0 -6  0  0 -6  0  0 -6  0  0 -6  0  0 -6  0  0 -6  0  0 -6  0  0 -6  0  0 -6  0  0 -6  0  0 -6  0  0 -6  0  0  70  0  0 -71  0  0 -6  0  0 
 0  0  1336 -6  0  0  70  0  0 -6  0  0  1  0  0  1  84  22  1  0  0  1  0  0  1  0  0  1  0  0  1  0  0  1  0  0  1  0  40 -6  0  0  8  0  0  8  0  0  8  9  1284  8  0  830  8  0  0 -6  0  0  1  0  0  1  0  0  1  0  0  1  0  0  1  0  0  1  0  0  1  0  0  1  0  0  1  0  0  1  0  0  1  0  0  1  0  0  1  0  0  1  0  0  1  0  0  1  0  0  1  0  0  1  0  0  1  0  0  1  0  0  1  0  0  1  0  0  1  0  0  1  0  0  1  0  0  1  0  0 -6  0  0  70  0  0 -6  0  0  0  0  1336 
 0  0  1336 -6  0  0  70  0  0 -6  0  0  1  0  0  1  0  0  1  0  40  1  0  0  1  0  0  1  0  0  1  0  38  1  0  0  1  0  41 -6  0  0  8  0  0  8  105  160  8  0  0  8  0  831  8  0  0 -6  0  0  1  0  0  1  0  0  1  0  0  1  0  0  1  0  0  1  0  0  1  0  0  1  0  0  1  0  0  1  0  40  1  0  0  1  0  0  1  0  0  1  0  0  1  0  0  1  0  0  1  0  0  1  0  0  1  0  0  1  0  0  1  0  0  1  0  0  1  0  0  1  0  0  1  84  22  1  0  0 -6  0  0  70  0  0 -6  0  0  0  0  1336 
 0  0  1336 -6  0  0  70  0  0 -6  0  0  1  0  0  1  0  40  1  0  41  1  566  199  1  0  0  1  0  40  1  0  39  1  0  0  1  0  0 -6  0  0  8  0  0  8  0  0  8  0  0  8  0  0  8  0  0 -6  0  0  1  0  0  1  0  0  1  0  40  1  0  0  1  0  0  1  0  0  1  0  0  1  0  0  1  0  0  1  0  41  1  0  0  1  0  38  1  0  38  1  0  0  1  0  0  1  0  0  1  0  0  1  0  0  1  0  0  1  0  0  1  0  0  1  0  0  1  0  0  1  0  0  1  300  208  1  0  0 -6  0  0  70  0  0 -6  0  0  0  0  1336 
 0  0  1336 -6  0  0  70  0  0 -6  0  0  1  0  0  1  0  41  1  0  38  1  0  0  1  0  0  1  0  41  1  0  0  1  0  0  1  0  0 -6  0  0  8  148  883  8  0  0  8  0  0  8  0  0  8  0  0 -6  0  0  1  0  0  1  0  40  1  0  41  1  0  40  1  0  0  1  0  0  1  0  0  1  0  0  1  0  0  1  216  191  1  0  0  1  143  39  1  0  39  1  0  40  1  0  0  1  0  0  1  0  0  1  0  0 -35  0  0 -35  0  0 -35  0  0 -35  0  0 -35  0  0  1  0  0  1  0  0  1  0  0 -6  0  0  70  0  0 -6  0  0  0  0  1336 
 0  0  1336 -6  0  0  70  0  0 -6  0  0  1  0  0  1  0  0  1  0  39  1  0  0  1  0  0  1  0  0  1  0  0  1  0  0  1  0  40 -6  0  0 -6  0  0 -6  0  0 -6  0  0  7  0  0 -6  0  0 -6  0  0  1  0  40  1  0  41  1  0  0  1  0  41  1  0  0  1  0  0  1  0  0  7  0  0  7  0  0  7  0  0  7  0  0  7  0  0  7  0  0  1  0  41  1  0  0  1  0  0  1  0  0 -35  0  0 -35  0  0  4  0  0  4  0  0  4  0  0 -35  0  0 -35  0  0  1  0  0  1  0  0 -6  0  0  70  0  0 -6  0  0  0  0  1336 
 0  0  1336 -6  0  0  70  0  0 -6  0  0  1  0  0  1  0  0  1  0  0  1  0  0  1  0  0  1  0  0  1  0  40  1  0  38  1  0  41  1  0  0  1  0  0  1  0  0  1  0  0  7  0  0  1  0  0  1  0  0  1  0  41  1  0  0  1  0  0  1  0  0  1  0  0  1  300  198  1  0  0  7  0  0  1  0  0  1  0  0  1  0  40  1  0  0  1  0  0  1  0  0  1  0  0  1  0  0 -35  0  0 -35  0  0  4  0  0  4  0  0  4  0  0  4  631  165  4  0  0 -35  0  0 -35  0  0  1  0  0 -6  0  0  70  0  0 -6  0  0  0  0  1336 
 0  0  1336 -6  0  0  70  0  0 -6  0  0  1  0  0  1  0  0  1  300  209  1  0  0  1  0  0  1  0  0  1  0  41  1  0  39  1  0  0  1  0  0  1  0  0  1  0  0  1  0  0  7  0  0  7  0  0  7  0  0  7  0  0  7  0  0  7  0  0  7  0  0  7  0  0  7  0  0  7  0  0  7  0  0  1  0  0  1  0  0  1  0  41  1  0  0  1  0  0 -35  0  0 -35  0  0 -35  0  0 -35  0  0  4  9  1284  4  0  0  4  0  0  4  118  857  4  0  0  4  0  0  4  9  1284 -35  0  0  1  0  0 -6  0  0  70  0  0 -6  0  0  0  0  1336 
 0  0  1336 -6  0  0  70  0  0 -6  0  0  1  0  38  1  0  0  1  0  0  1  0  0  1  0  38  1  0  0  1  0  0  1  0  0  1  0  0  1  0  0  1  0  0  1  0  0  1  0  0  1  0  0  1  0  0 -6  0  0 -6  0  0 -6  0  0 -6  0  0 -6  0  0 -6  0  0 -6  0  0 -6  0  0  7  0  0  1  0  0  1  0  0  1  0  0  1  0  0 -35  0  0 -35  0  0  4  0  0  4  579  323 -35  0  0  4  0  0  4  0  0  4  0  0  4  0  0  4  0  0  4  0  0  4  0  0 -35  0  0  1  0  0 -6  0  0  70  0  0 -6  0  0  0  0  1336 
 0  0  1336 -6  0  0  70  0  0 -6  0  0  1  0  39  1  0  0  1  0  0  1  0  0  1  0  39  1  0  38  1  0  0  1  0  0  1  0  0  1  0  0  1  0  0  1  0  0  1  0  40  1  0  0  1  0  0 -6  0  0  85  0  0  85  0  820  85  0  0  85  0  0  85  0  0  85  0  0 -6  0  0  7  0  0  1  0  0  1  0  0  1  0  0  1  0  0 -35  0  0  4  0  0  4  0  0  4  0  0 -35  0  0  4  0  858  4  0  858  4  0  858  4  0  0  4  0  858  4  0  858  4  0  858 -35  0  0  1  0  0 -6  0  0  70  0  0 -6  0  0  0  0  1336 
 0  0  1336 -6  0  0  70  0  0 -6  0  0  1  0  0  1  0  0  1  0  0  1  0  40  1  0  0  1  0  39  1  0  0  1  0  0  1  0  0  1  0  40  1  0  0  1  0  0  1  0  41  1  0  0  1  0  0 -6  0  0  85  0  181  85  47  820  85  0  0  85  0  0  85  0  0  85  0  0  7  0  0  7  0  0  1  0  0  1  0  0  1  0  0  1  0  0 -35  0  0  4  0  0  4  0  0  4  0  0  4  176  907  4  0  0  4  0  0  4  0  0  4  0  0  4  0  0  4  0  0  4  0  0 -35  0  0  1  0  0 -6  0  0  70  0  0 -6  0  0  0  0  1336 
 0  0  1336 -6  0  0  70  0  0 -6  0  0  1  0  0  1  0  0  1  0  0  1  0  41  1  0  0  1  0  0  1  84  22  1  0  0  1  0  0  1  0  41  1  0  0  1  0  0  1  0  0  1  0  0  1  0  0 -6  0  0  85  0  0  85  0  820  85  0  0  85  0  0  85  0  0  85  0  0 -6  0  0  7  0  0  1  0  0  1  0  38  1  0  0  1  0  40 -35  0  0  4  0  0  4  0  0  4  0  0 -35  0  0  4  0  858  4  0  858  4  0  858  4  0  0  4  0  858  4  0  858  4  0  858 -35  0  0  1  0  0 -6  0  0  70  0  0 -6  0  0  0  0  1336 
 0  0  1336 -6  0  0  70  0  0 -6  0  0  1  0  0  1  0  0  1  0  0  1  0  0  1  0  0  1  0  0  1  0  0  1  0  0  1  0  0  1  0  0  1  0  0  1  0  0  1  0  0  1  0  0  1  0  40 -6  0  0  85  0  0  85  0  820  85  0  0  85  0  0  85  0  0  85  185  839 -6  0  0  7  0  0  1  0  0  1  0  39  1  0  0  1  0  41 -35  0  0 -35  0  0 -35  0  0 -35  0  0 -35  0  0  4  0  0  4  0  0  4  0  0  4  0  0  4  0  0  4  0  0  4  0  0 -35  0  0  1  0  0 -6  0  0  70  0  0 -6  0  0  0  0  1336 
 0  0  1336 -6  0  0  70  0  0 -6  0  0 -6  0  0 -6  0  0 -6  0  0 -6  0  0 -6  0  0 -6  0  0 -6  0  0 -6  0  0 -6  0  0 -6  0  0 -6  0  0 -6  0  0 -6  0  0  1  0  0  1  0  41 -6  0  0 -6  0  0 -6  0  0 -6  0  0 -6  0  0 -6  0  0 -6  0  0 -6  0  0  7  0  0  1  0  0  1  0  0  1  0  40  1  0  0  1  0  0  1  0  0  1  0  0  1  0  0 -35  0  0  4  0  858  4  0  858  4  0  858  4  0  0  4  0  858  4  0  858  4  0  858 -35  0  0  1  0  0 -6  0  0  70  0  0 -6  0  0  0  0  1336 
 0  0  1336 -6  0  0  70  0  0 -6  0  0  1  0  0  1  0  0  1  84  22  1  0  0  1  0  0 -72  0  0  1  0  0 -72  0  0  1  162  197  1  84  22  1  0  0  1  0  40 -6  0  0  1  0  0  1  0  0  1  0  0  1  0  0  1  0  0  1  0  0  1  0  0  1  0  0  1  0  0  1  0  0  7  0  0  1  0  0  1  0  0  1  0  41  1  0  0  1  0  0  1  84  22  1  0  40  1  0  0 -35  0  0  4  0  0  4  0  0  4  0  0  4  0  0  4  0  0  4  0  0  4  0  0 -35  0  0  1  0  0 -6  0  0  70  0  0 -6  0  0  0  0  1336 
 0  0  1336 -6  0  0  70  0  0 -6  0  0  1  0  0  1  0  40  7  0  0  7  0  0  7  0  0  7  0  0  7  0  0  7  0  0  7  0  0  7  0  0  1  0  0  1  0  41 -6  0  0 -6  0  0 -6  0  0 -6  0  0 -6  0  0 -6  0  0 -6  0  0 -6  0  0 -6  0  0 -6  0  0  1  0 -9  7  0  0  1  0  0  1  0  0  1  0  0  1  121  176  1  0  0  1  0  0  1  0  41  1  0  40 -35  0  0  4  0  858  4  0  858  4  0  858  4  0  0  4  0  858  4  0  858  4  0  858 -35  0  0  1  0  0 -6  0  0  70  0  0 -6  0  0  0  0  1336 
 0  0  1336 -6  0  0  70  0  0 -6  0  0  1  0  40  1  0  41  7  0  0  1  0  40 -72  0  0 -72  0  0  7  0  0 -72  0  0 -72  0  0  7  0  0  1  0  0  1  0  0 -6  0  0 -6  0  0  85  0  0  85  0  820  85  0  0  85  0  0  85  0  0  85  0  0  85  183  845 -6  0  0  1  0 -9  7  0  0  1  0  0  1  0  0  1  0  0  1  0  0  1  0  0  1  0  0  1  0  0  1  0  41 -35  0  0 -35  0  0 -35  0  0 -35  0  0  7  0  0 -35  0  0 -35  0  0 -35  0  0 -35  0  0  1  0  0 -6  0  0  70  0  234 -6  0  0  0  0  1336 
 0  0  1336 -6  0  0  70  0  0 -6  0  0  1  0  41  1  0  0  7  0  0  1  0  41  1336  0 -10  1336  0 -20  7  0  0  1336  0 -20  1336  0 -12  7  0  0  1  161  196  1  0  0 -6  0  0 -6  0  0  85  0  0  85  68  821  85  0  0  85  0  0  85  226  180  85  0  0  85  0  0 -6  0  0  1  0 -9  7  0  0  1  0  0  1  0  0  1  0  0  1  0  0  1  0  0  1  0  0  1  0  0  1  0  0  1  0  0  1  0  0  1  0  0  1  0  30  7  0  0  1  0  30  1  0  0  1  0  0  1  0  0  1  0  0 -6  0  0  70  0  0 -6  0  0  0  0  1336 
 0  0  1336 -6  0  0  70  0  0 -6  0  0  1  0  0  1  160  189  7  0  0  1336  0 -10  1336  0 -21  0  0  1336  1336  0 -29  0  0  1336  1336  0 -14  7  0  0  1  0  0  1  84  22 -6  0  0 -6  0  0  85  0  177  85  68  821  85  0  0  85  0  0  85  0  0  85  0  0  85  0  0  7  0  0  7  0  0  7  0  0  7  0  0  7  0  0  7  0  0  7  0  0  7  0  0  7  0  0  7  0  0  7  0  0  7  0  0  7  0  0  7  0  0  7  0  0  7  0  0  1  0  0  1  0  0  1  0  0  1  0  0  1  0  0 -6  0  0  70  0  0 -6  0  0  0  0  1336 
 0  0  1336 -6  0  0  70  0  0 -6  0  0  1  0  0  1  0  0  7  0  0  1336  0 -18  1336  0  1292  1336  389  213  1336  0 -29  0  0  1336  1336  0 -14  7  0  0  1  0  40  1  0  0 -6  0  0 -6  0  0  85  0  0  85  0  820  85  0  0  85  0  0  85  0  0  85  0  0  85  0  0 -6  0  0  1  84  22  7  0  0  1  0  30  1  0  30  1  0  30  1  0  30  1  0  30  1  0  30  1  0  30  1  0  30  1  0  30  1  0  30  7  0  0  1  0  30  1  0  30  1  0  30  1  0  30  1  0  30  1  0  30  1  0  0 -6  0  0  70  0  0 -6  0  0  0  0  1336 
 0  0  1336 -6  0  0  70  0  0 -6  0  0  1  0  40  1  0  0  7  0  0  1336  0 -18  0  0  1336  0  0  1336  1336  0 -29  0  0  1336  1336  0 -14  7  0  0  1  0  41  1  0  40 -6  0  0 -6  0  0  85  0  0  85  0  820  85  0  0  85  0  0  85  0  873  85  0  873  85  276  884 -6  0  0  1  0 -9  7  0  0  1  0  30  7  0  0  7  0  0  7  0  0  7  0  0  7  0  0  7  192  195  7  0  0  7  0  0  7  0  0  7  0  0  7  0  0  7  0  0  7  0  0  7  0  0  7  0  0  1  0  30  1  0  0 -6  0  0  70  0  0 -6  0  0  0  0  1336 
 0  0  1336 -6  0  0  70  0  0 -6  0  0  1  0  41  1  84  22  7  0  0  1336  0 -11  1336  0 -17  1336  0 -17  7  0  0  1336  0 -17  1336  0 -13  7  0  0  1  0  0  1  0  41 -6  0  0 -6  0  0 -6  0  0 -6  0  0 -6  0  0 -6  0  0 -6  0  0 -6  0  0 -6  0  0 -6  0  0  1  0 -9  7  0  0  1  0  30  7  0  0  1  0  30  48  0  0  48  0  0  48  0  0  48  0  0  1  0  30  7  0  0  1  0  30  7  0  0  1  0  30  1  0  30  1  0  30  1  0  30  7  0  0  1  0  30  1  0  40 -6  0  0  70  0  0 -6  0  0  0  0  1336 
 0  0  1336 -6  0  0  70  0  0 -6  0  0  1  0  0  1  0  0  7  0  0  7  0  0  7  0  0  7  0  0  7  0  0  7  0  0  7  0  0  7  0  0  1  0  0  1  0  0 -6  0  0 -6  0  0  7  0  0  7  120  323 -6  0  0  1  0  0  1  0  0  1  0  40  1  0 -9  1  0 -9  1  0 -9  7  0  0  1  0  30  7  0  0  1  0  30  48  0  0  48  0  0  48  0  0  48  0  0  1  0  30  7  0  0  1  0  30  1  0  0  1  0  0  1  51  182  1  0  40  1  0  30  7  0  0  1  0  30  1  0  41 -6  0  0  70  0  0 -6  0  0  0  0  1336 
 0  0  1336 -6  0  0  70  0  0 -6  0  0  1  0  0  1  0  40 -72  0  0  1  84  22 -72  0  0  7  0  0 -72  0  0 -72  0  0 -72  0  0  1  84  22  1  0  0  1  0  0 -6  0  0 -6  0  0  7  0  0  7  0  0 -6  0  0  1  0  0  1  0  0  1  0  41  7  0  0  7  0  0  7  0  0  7  0  0  7  0  0  7  0  0  7  0  0  7  0  0  7  0  0  7  0  0  7  0  0  7  0  0  7  0  0  1  0  30  1  0  0  1  0  0  1  0  0  1  0  41  1  0  30  7  0  0  1  0  30  1  0  0 -6  0  0  70  0  0 -6  0  0  0  0  1336 
 0  0  1336 -6  0  0  70  0  0 -6  0  0  1  0  0  1  0  41  1  0  0  1  0  0 -72  0  0  7  0  0 -72  0  0  1  0  0  1  0  0  1  0  0  1  0  0  1  84  22 -6  0  0 -6  0  0  7  274  846 -6  0  0 -6  0  0  1  0  0  1  0  0  1  0  0  7  0  0  1  0  0  1  0  40  1  0  0  1  0  30  7  0  0  1  0  30  48  0  0  48  0  0  48  0  0  48  0  0  1  0  30  7  0  0  1  0  30  1  0  0  1  0  0  1  0  0  1  0  0  1  0  30  7  0  0  1  0  30  1  0  0 -6  0  0  70  0  0 -6  0  0  0  0  1336 
 0  0  1336 -6  0  0  70  0  0 -6  0  0  1  0  0  1  0  0  1  0  0  1  0  0 -72  0  0  7  0  0 -72  0  0 -6  0  0 -6  0  0 -6  0  0 -6  0  0 -6  0  0 -6  0  0  1  0  0  7  0  0  1  0  0  1  0  0  1  0  0  1  0  0  1  0  0  7  0  0  1  0  0  1  0  41  1  0  40  1  0  30  7  0  0  1  0  30  48  0  0  48  0  0  48  0  0  48  0  0  1  0  30  7  0  0  1  0  30  1  0  30  1  0  30  7  0  0  1  0  30  1  0  30  7  0  0  1  0  30  1  0  0 -6  0  0  70  0  0 -6  0  0  0  0  1336 
 0  0  1336 -6  0  0  70  0  0 -6  0  0 -6  0  0 -6  0  0 -6  0  0 -6  0  0 -72  0  0  7  0  0 -72  0  0 -6  0  0  8  0  0  8  9  1284  8  0  830  8  0  0 -6  0  0  1  0  0  7  0  0  1  0  0  1  0  0  1  0  0  1  0  0  1  0  0  7  0  0  1  0  0  1  0  0  1  0  41  1  0  30  7  0  0  7  0  0  7  0  0  7  0  0  7  0  0  7  0  0  7  0  0  7  0  0  7  0  0  7  0  0  7  0  0  7  0  0  7  0  0  7  0  0  7  0  0  1  0  30  1  0  0 -6  0  0  70  0  0 -6  0  0  0  0  1336 
 0  0  1336 -6  0  0  70  0  0 -6  0  0  8  185  845  8  0  873  8  0  873 -6  0  0 -72  0  0  7  0  0 -72  0  0 -6  0  0  8  0  0  8  0  0  8  0  831  8  0  0 -6  0  0  1  0  0  7  0  0  7  0  0  7  0  0  7  0  0  7  0  0  7  0  0  7  0  0  1  0  0  1  0  0  1  0  0  1  0  30  1  0  30  1  0  30  1  0  30  1  0  30  1  0  30  1  0  30  1  142  30  1  0  30  1  0  30  1  0  30  1  0  30  7  0  0  1  0  30  1  0  30  1  0  30  1  0  30  1  0  0 -6  0  0  70  0  0 -6  0  0  0  0  1336 
 0  0  1336 -6  0  0  70  0  0 -6  0  0  8  0  0  8  0  801  8  224  200 -6  0  0 -72  0  0  7  0  0 -72  0  0 -6  0  0  8  0  0  8  0  0  8  0  0  8  0  0 -6  0  0  1  0  0  1  0  0  1  0  0  1  0  0  1  0  0  1  0  0  7  0  0  7  0  0  1  0  0  1  0  0  1  0  0  1  0  0  1  0  0  1  0  0  1  0  0  1  0  0  1  0  0  1  0  0  1  0  0  1  0  0  1  0  0  1  0  0  1  0  0  7  0  0  1  0  0  1  0  0  1  0  0  1  0  40  1  0  0 -6  0  0  70  0  0 -6  0  0  0  0  1336 
 0  0  1336 -6  0  0  70  0  0 -6  0  0  8  0  0  8  0  802  8  0  0 -6  0  0 -6  0  0  7  0  0 -72  0  0 -6  0  0 -6  0  0  8  4  851 -6  0  0 -6  0  0 -6  0  874 -6  0  876 -6  0  878 -6  0  0 -6  0  0 -6  0  0  1  0  0  7  0  0  7  0  0  7  0  0  7  0  0  7  0  0  7  0  0  7  0  0  7  0  0  7  0  0  7  0  0  7  0  0  7  0  0  7  0  0  7  0  0  7  0  0  7  0  0  7  0  0  7  0  0  7  0  0  7  0  0  1  0  0  1  0  41  1  84  22 -6  0  0  70  0  0 -6  0  0  0  0  1336 
 0  0  1336 -6  0  0  70  0  0 -6  0  0  8  0  0  8  0  0  8  0  0  8  0  0  7  2  849  7  0  0 -72  0  0 -6  0  0  8  182  845  8  0  0  8  0  0  8  0  0  8  0  875  8  388  877  8  0  879  8  0  0  8  9  1284 -6  0  0  1  0  0  7  0  0  7  0  0  7  0  0  1  0  0  1  0  0 -6  0  0 -6  0  0 -6  0  0 -6  0  0 -6  0  0 -6  0  0 -6  0  0 -6  0  0 -6  0  0 -6  0  0 -6  0  0 -6  0  0  1  0  0  1  0  40  7  0  0  1  0  0  1  0  0  1  0  0 -6  0  0  70  0  0 -6  0  0  0  0  1336 
 0  0  1336 -6  0  0  70  0  0 -6  0  0  8  9  1284  8  0  0  8  0  0  8  0  0 -6  0  0  7  0  0  7  0  0  7  780  849  8  0  0  8  0  0  8  0  0  8  0  0  8  0  0  8  0  0  8  0  0  8  0  0  8  0  0 -6  0  0  1  0  0  7  0  0  7  0  0  7  0  0  1  0  0  1  0  0 -6  0  0  8  0  0  8  0  0  8  0  0  8  0  0  8  185  845  8  0  820  8  0  873  8  0  884  8  0  884  8  0  0 -6  0  0  1  0  0  1  0  41  7  0  0  7  0  0  7  0  0  1  0  40 -6  0  0  70  0  0 -6  0  0  0  0  1336 
 0  0  1336 -6  0  0  70  0  0 -6  0  0 -6  0  0 -6  0  0 -6  0  0 -6  0  0 -6  0  0  7  0  0 -72  0  0 -6  0  0  8  0  0  8  0  0  8  0  0  8  0  0  8  0  0  8  0  0  8  0  0  8  0  0  8  0  0 -6  0  0  1  0  0  7  0  0  7  0  0  7  0  0  1  114  180  1  0  0 -6  0  0  8  0  0  8  0  836  8  0  836  8  0  0  8  0  0  8  0  820  8  0  0  8  0  0  8  0  160  8  0  883 -6  0  0  1  0  0  1  0  0  1  0  0  1  0  0  7  0  0  1  0  41 -6  0  0  70  0  0 -6  0  0  0  0  1336 
 0  0  1336 -6  0  0  70  0  0 -6  0  0  8  0  0  8  0  801  8  9  1284  8  0  0 -6  0  0  7  0  0 -72  0  0 -6  0  0  8  0  0  8  0  0  8  0  0  8  0  0  8  0  0  8  0  0  8  0  0  8  300  210  8  0  0 -6  0  0  1  0  0  7  0  0  7  0  0  7  0  0  1  0  0  1  0  0 -6  0  0  8  0  0  8  0 -837  8  0 -837  8  0  0  8  0  0  8  0  861  8  0  856  8  0  856  8  73  822  8  0  856 -6  0  0 -6  0  0 -6  0  0 -6  0  0 -6  0  0  7  4  851 -6  0  0 -6  0  0  70  0  0 -6  0  0  0  0  1336 
 0  0  1336 -6  0  0  70  0  0 -6  0  0  8  0  0  8  0  802  8  0  0  8  0  0 -6  0  0  7  0  0 -72  0  0 -6  0  0  8  0  856  8  0  860  8  0  0  8  0  0  8  0  0  8  0  0  8  0  0  8  0  0  8  0  0 -6  0  0  1  225  867  7  0  0  7  0  0  7  0  0  1  0  40  1  0  0 -6  0  0  8  0  0  8  0  836  8  0  836  8  0  0  8  0  0  8  0  0  8  0  0  8  0  0  8  0  0  8  0  0 -6  0  0  8  0  0  8  0  830  8  9  1284  8  0  0  8  0  0  8  0  0 -6  0  0  70  0  0 -6  0  0  0  0  1336 
 0  0  1336 -6  0  0  70  0  0 -6  0  0  8  0  0  8  0  0  8  0  0  8  0  0  7  2  849  7  0  0 -72  0  0 -6  0  0  8  0  0  8  0  820  8  0  0  8  0  0  8  0  0  8  0  0  8  0  0  8  0  0  8  0  0  7  0  0  7  0  0  7  0  0  7  0  0  7  0  0  1  0  41  1  0  0 -6  0  0  8  0  0  8  0 -837  8  0 -837  8  0  0  8  0  0  8  0  0  8  0  0  8  0  836  8  0  836  8  0  836 -6  0  0  8  0  0  8  0  831  8  0  0  8  0  0  8  0  0  8  0  0 -6  0  0  70  0  0 -6  0  0  0  0  1336 
 0  0  1336 -6  0  0  70  0  234 -6  0  0  8  0  0  8  0  0  8  0  0  8  0  0 -6  0  0 -72  0  0  1  0  0 -6  0  0  8  0  190  8  72  820  8  0  0  8  0  0  8  0  0  8  0  0  8  0  0  8  0  0  8  0  0 -6  0  0  1  0  40  7  0  0  7  0  0  7  0  0  7  0  0  7  0  0  7  0  0  8  0  0  8  0  0  8  0  0  8  0  0  8  0  0  8  300  199  8  0  0  8  0 -837  8  0 -837  8  0 -837 -6  0  0  8  0  0  8  0  0  8  0  0  8  0  0  8  130  205  8  0  0 -6  0  0  70  0  0 -6  0  0  0  0  1336 
 0  0  1336 -6  0  0  70  0  0 -6  0  0  8  0  873  8  276  884  8  0  0  8  0  0 -6  0  0  1  0  0  1  84  22 -6  0  0  8  0  0  8  0  820  8  0  0  8  0  0  8  0  0  8  0  0  8  0  0  8  0  0  8  9  1284 -6  0  0  1  0  41  7  0  0  7  0  0  7  0  0  1  0  0  1  0  0 -6  0  0  8  0  0  8  0  0  8  0  0  8  0  0  8  0  0  8  0  0  8  0  0  8  0  0  8  0  0  8  0  0 -6  0  0  8  0  0  8  0  0  8  0  0  8  0  0  8  0  0  8  0  0 -6  0  0  70  0  0 -6  0  0  0  0  1336 
-6  0  0 -71  0  0  70  0  0 -6  0  0 -6  0  0 -6  0  0 -6  0  0 -6  0  0 -6  0  0 -6  0  0 -6  0  0 -6  0  0 -6  0  0 -6  0  0 -6  0  0 -6  0  0 -6  0  0 -6  0  0 -6  0  0 -6  0  0 -6  0  0 -6  0  0 -6  0  0  7  31  171  7  0  0  7  31  171 -6  0  0 -6  0  0 -6  0  0 -6  0  0 -6  0  0 -6  0  0 -6  0  0 -6  0  0 -6  0  0 -6  0  0 -6  0  0 -6  0  0 -6  0  0 -6  0  0 -6  0  0 -6  0  0 -6  0  0 -6  0  0 -6  0  0 -6  0  0 -6  0  0  70  0  0 -71  0  0 -6  0  0 
-71  0  0  70  0  0  70  0  0  70  0  0  70  0  0  70  0  0  70  0  0  70  0  0  70  0  0  70  0  0  70  0  0  70  0  0  70  0  0  70  0  0  70  0  226  70  0  0  70  0  0  70  0  0  70  0  0  70  0  0  70  0  0  70  0  0 -6  0  0  7  0  0  7  0  0  7  0  0 -6  0  0  70  0  0  70  0  0  70  0  0  70  0  0  70  0  0  70  0  0  70  0  0  70  0  0  70  0  0  70  0  0  70  0  0  70  0  0  70  0  0  70  0  0  70  0  0  70  0  0  70  0  0  70  0  0  70  0  0  70  0  0  70  0  0  70  0  0 -71  0  0 
-6  0  0  70  0  226  70  0  0 -71  0  0 -6  0  0 -6  0  0 -6  0  0  70  0  0 -6  0  0 -6  0  0 -6  0  0 -6  0  0 -6  0  0 -6  0  0 -6  0  0 -6  0  0 -6  0  0 -6  0  0 -6  0  0 -6  0  0 -6  0  0 -6  0  0 -6  0  0  7  0  0  7  0  0  7  0  0 -6  0  0 -6  0  0 -6  0  0 -6  0  0 -6  0  0 -6  0  0 -6  0  0 -6  0  0 -6  0  0 -6  0  0 -6  0  0 -6  0  0 -6  0  0 -6  0  0 -6  0  0 -6  0  0  70  0  0 -6  0  0 -6  0  0 -6  0  0 -71  0  0  70  0  0  70  0  226 -6  0  0 
-71  0  0 -6  0  0 -71  0  0 -6  0  0  0  0  1336  0  0  1336 -6  0  0  70  0  0 -6  0  0  0  0  1336  0  0  1336  0  0  1336  0  0  1336  0  0  1336  0  0  1336  0  0  1336  0  0  1336  0  0  1336  0  0  1336  0  0  1336  0  0  1336  0  0  1336 -6  0  0  7  0  0  7  0  0  7  0  0 -6  0  0  0  0  1336  0  0  1336  0  0  1336  0  0  1336  0  0  1336  0  0  1336  0  0  1336  0  0  1336  0  0  1336  0  0  1336  0  0  1336  0  0  1336  0  0  1336  0  0  1336 -6  0  0  70  0  0 -6  0  0  0  0  1336  0  0  1336 -6  0  0 -71  0  0 -6  0  0 -71  0  0 
 0  0  1336  0  0  1336  0  0  1336  0  0  1336  0  0  1336  0  0  1336 -6  0  0  70  0  0 -6  0  0  0  0  1336  0  0  1336  0  0  1336  0  0  1336  0  0  1336  0  0  1336  0  0  1336  0  0  1336  0  0  1336  0  0  1336  0  0  1336  0  0  1336  0  0  1336 -6  0  0  7  0  0  7  0  0  7  0  0 -6  0  0  0  0  1336  0  0  1336  0  0  1336  0  0  1336  0  0  1336  0  0  1336  0  0  1336  0  0  1336  0  0  1336  0  0  1336  0  0  1336  0  0  1336  0  0  1336  0  0  1336 -6  0  0  70  0  0 -6  0  0  0  0  1336  0  0  1336  0  0  1336  0  0  1336  0  0  1336  0  0  1336 
 1336  0 -17  1336  0 -17  1336  0 -17  1336  0 -17  1336  0 -17  1336  0 -17 -6  0  0  70  0  0 -6  0  0  1336  0 -17  1336  0 -17  1336  0 -17  1336  0 -17  1336  0 -17  1336  0 -17  1336  0 -17  1336  0 -17  1336  0 -17  1336  0 -17  1336  0 -17  1336  0 -17  1336  0 -17 -6  0  0  7  0  0  7  0  0  7  13  867 -6  0  0  1336  0 -17  1336  0 -17  1336  0 -17  1336  0 -17  1336  0 -17  1336  0 -17  1336  0 -17  1336  0 -17  1336  0 -78  1336  0 -69  1336  0 -69  1336  0 -69  1336  0 -69  1336  0 -69 -6  0  0  70  0  234 -6  0  0  1336  0 -69  1336  0 -69  1336  0 -69  1336  0 -69  1336  0 -69  1336  0 -69 
 1  0  0  1  0  0  1  0  0  1  0  0  1  0  0  1  0  0 -6  0  0  70  0  0 -6  0  0  1  0  0  1  0  0  1  0  0  1  0  0  1  0  0  1  0  0  1  0  0  1  0  0  1  0  0  1  0  0  1  84  22  1  0  0  1  0  0  1  0  0  7  0  0  7  0  0  7  0  0  1  50  163  1  0  0  1  0  0  1  0  0  1  0  0  1  0  0  1  0 -890  1  0  0  1  0 -69  67  0 -69  32  0  0  32  0 -890  32  0  891  32  0  0  32  0  880 -6  0  0  70  0  0 -6  0  0  32  0  0  32  0  0  32  0  0  32  0  0  32  0  0  32  0  0 
 1  0  0  1  0  0  1  0  0  1  0  0  1  0  0  1  0  0 -6  0  0  70  0  0 -6  0  0  1  0  0  1  0  0  1  0  0  1  0  0  1  0  0  1  0  0  1  0  0  1  0  0  1  0  0  1  0  0  1  0  0  1  0  0  1  0  0  1  0  0  7  0  0  7  0  0  7  0  0  1  0  0  1  0  0  1  0  0  1  0  0  1  0  0  1  0 -890  1  220  202  67  0 -69  32  0  0  32  0 -890  32  0  889  32  0  0  32  0  0  32  0  0  32  0  888 -6  0  0  70  0  0 -6  0  0  32  0  0  32  0  0  32  0  0  32  0  0  32  0  0  65  0  64 
 1  0  0  1  0  0  1  0  0  1  0  0  1  0  0  1  0  0 -6  0  0  70  0  0 -6  0  0  1  0  0  1  0  0  1  0  0  1  0  0  1  0  0  1  0  0  1  0  0  1  0  0  1  0  0  1  0  0 -6  0  0 -71  0  0 -6  0  0 -71  0  0 -6  0  0  7  0  0 -6  0  0 -71  0  0 -6  0  0 -71  0  0 -6  0  0  1  0 -69  1  0 -69  67  0 -69  32  0  888  32  0  0  32  0  880  32  0 -890  32  0  0  32  0  891  32  141  880  32  0  889 -6  0  0  70  0  0 -6  0  0  32  0  0  32  0  0  32  0  0  65  0  64  1  0  64  1  0  0 
 1  0  0  1  0  0  1  0  0  1  0  0  1  0  0 -6  0  0 -71  0  0  70  0  0 -6  0  0 -6  0  0 -6  0  0 -6  0  0 -6  0  0 -6  0  0 -6  0  0 -6  0  0 -6  0  0 -6  0  0 -6  0  0 -71  0  0  70  0  0  70  0  0  70  0  0 -71  0  0  7 -22  0 -71  0  0  70  0  0  70  0  0  70  0  0 -71  0  0 -6  0  0 -6  0  0 -6  0  0 -6  0  0 -6  0  0 -6  0  0 -6  0  0 -6  0  0 -6  0  0 -6  0  0 -6  0  0 -6  0  0  70  0  0 -71  0  0 -6  0  0  32  0  0  32  0  0  65  0  0  1  0  0  1  0  0 
 1  0  0  1  0  0  1  0  0  1  0  0  1  0  0 -71  0  0  70  0  0  70  0  0  70  0  0  70  0  0  70  0  0  70  0  0  70  0  0  70  0  0  70  0  0  70  0  0  70  0  0  70  0  0  70  0  0  70  0  0  70  0  0  70  0  234  70  0  0 -6  0  0 -7  0  0 -6  0  0  70  0  0  70  0  0  70  0  0  70  0  0  70  0  0  70  0  0  70  0  0  70  0  0  70  0  0  70  0  0  70  0  0  70  0  0  70  0  0  70  0  0  70  0  0  70  0  0  70  0  0  70  0  0 -71  0  0  32  0  0  65  0  64  1  0  0  1  0  0  1  0  0 
 1  0  0  1  0  0  1  0  0  1  0  0  1  0  0 -6  0  0  70  0  226  70  0  0 -71  0  0 -6  0  0 -6  0  0 -6  0  0 -6  0  0 -6  0  0 -6  0  0 -6  0  0 -6  0  0 -6  0  0 -6  0  0 -71  0  0  70  0  0  70  0  0  70  0  226 -71  0  0  7  0  0 -71  0  0  70  0  226  70  0  0  70  0  0 -71  0  0 -6  0  0 -6  0  0 -6  0  0 -6  0  0 -6  0  0 -6  0  0 -6  0  0 -6  0  0 -6  0  0 -6  0  0 -6  0  0 -71  0  0  70  0  0  70  0  226 -6  0  0  32  0  0  65  0  0  1  0  0  1  0  0  1  0  0 
 1  0  0  1  0  0  1  0  0  1  0  0  1  0  0 -71  0  0 -6  0  0 -71  0  0 -6  0  0  1  0  0  1  0  0  1  0  0  1  0  0  1  0  0  1  0  0  1  0  0  1  0  0  1  0  0  1  0  0 -6  0  0 -71  0  0 -6  0  0 -71  0  0 -6  0  0  7  0  0 -6  0  0 -71  0  0 -6  0  0 -71  0  0 -6  0  0  1  0  0  1  0  0  1  0  0  1  0  0  1  0  0  1  0  0  1  0  0  1  0  0  66  0  0  67  0  64  32  0  0 -6  0  0 -71  0  0 -6  0  0 -71  0  0  32  0  0  65  0  0  1  0  0  1  0  0  1  0  0 
 1  0  0  1  0  0  1  0  0  1  0  0  1  0  0  1  0  0  1  0  0  1  0  0  1  0  0  1  0  0  1  0  0  1  0  0  1  0  0  1  0  0  1  0  0  1  0  0  1  0  0  1  0  0  1  0  0  1  0  0  1  0  0  1  0  0  1  0  0  1  0  0  7  0  0  1  0  0  1  0  0  1  0  0  1  0  0  1  0  0  1  0  0  1  0  0  1  0  0  1  0  0  1  0  0  1  0  0  1  0  0  1  0  0  1  0  0  1  0  0  66  0  0  66  0  0  66  0  0  66  0  0  67  0  64  65  0  64  1  0  0  1  0  0  1  0  0  1  0  0 
 25            49 
 1336 
