 5             6 
 8  0  0  8  0  0  8  0  0  8  0  0  8  0  0 
 8  0  0  0  0  0  8  0  0  0  0  0  8  0  0 
 8  0  0  8  0  0  8  0 -917  8  0  0  8  0  0 
 8  0  0  0  0  0  8  0  0  0  0  0  8  0  0 
 8  0  0  8  0  0  8  0  0  8  0  0  8  0  0 
 0  0  0  0  0  0  8 -405  0  0  0  0  0  0  0 
 3             6 
 0 
